Step, Memory, Heap, Allocated, Reclaimed, Live, Mutator, Collector
0, 4653056, 761784, 1719908, 958124, 761568, 80399151, 18696337
1, 6160384, 1521784, 3440828, 1919044, 1521568, 89205364, 37370729
2, 6160384, 3242768, 5161812, 1919044, 1521568, 92293749, 317
3, 10223616, 3041784, 6882876, 3841092, 3041568, 94887567, 74719513
4, 10223616, 4762804, 8603896, 3841092, 3041568, 95672567, 317
5, 13238272, 4561784, 10324996, 5763212, 4561568, 97678668, 112059147
6, 13238272, 6282820, 12046032, 5763212, 4561568, 98654923, 317
7, 16252928, 6081784, 13767196, 7685412, 6081568, 99870474, 149399147
8, 16252928, 7802772, 15488184, 7685412, 6081568, 99865744, 317
9, 16252928, 9523936, 17209348, 7685412, 6081568, 100241988, 317
10, 21823488, 8361784, 18930384, 10568600, 8361568, 102056803, 205423421
11, 21823488, 10082980, 20651580, 10568600, 8361568, 102061554, 317
12, 21823488, 11803984, 22372584, 10568600, 8361568, 102056254, 317
13, 21823488, 13525148, 24093748, 10568600, 8361568, 104015974, 317
14, 28835840, 11401784, 25814816, 14413032, 11401568, 104247706, 280111473
15, 28835840, 13123012, 27536044, 14413032, 11401568, 104252221, 317
16, 28835840, 14844128, 29257160, 14413032, 11401568, 104249356, 317
17, 28835840, 16565132, 30978164, 14413032, 11401568, 104246077, 317
18, 34930688, 14441784, 32699328, 18257544, 14441568, 104250356, 354786349
19, 34930688, 16162916, 34420460, 18257544, 14441568, 104992627, 317
20, 34930688, 17884016, 36141560, 18257544, 14441568, 106438845, 317
21, 34930688, 19605084, 37862628, 18257544, 14441568, 106437883, 317
22, 34930688, 21326280, 39583824, 18257544, 14441568, 106441200, 317
23, 43450368, 18241784, 41304956, 23063172, 18241568, 106439630, 448149891
24, 43450368, 19962916, 43026088, 23063172, 18241568, 106439748, 317
25, 43450368, 21683920, 44747092, 23063172, 18241568, 106435900, 317
26, 43450368, 23405020, 46468192, 23063172, 18241568, 108159577, 317
27, 43450368, 25126216, 48189388, 23063172, 18241568, 108631377, 317
28, 43450368, 26847284, 49910456, 23063172, 18241568, 108627765, 317
29, 53542912, 22801784, 51631588, 28829804, 22801568, 108629630, 560178675
30, 53542912, 22803036, 51632840, 28829804, 22801568, 991449278, 317
31, 53542912, 22804196, 51634000, 28829804, 22801568, 991448739, 317
32, 53542912, 22805356, 51635160, 28829804, 22801568, 991448739, 317
33, 53542912, 22806516, 51636320, 28829804, 22801568, 991448739, 317
34, 53542912, 22807676, 51637480, 28829804, 22801568, 991448739, 317
35, 53542912, 22808836, 51638640, 28829804, 22801568, 991448739, 317
36, 53542912, 22809996, 51639800, 28829804, 22801568, 991448739, 317
37, 53542912, 22811156, 51640960, 28829804, 22801568, 991448739, 317
38, 53542912, 22812316, 51642120, 28829804, 22801568, 991448739, 317
39, 53542912, 22813476, 51643280, 28829804, 22801568, 991448739, 317
40, 53542912, 22814492, 51644296, 28829804, 22801568, 14146, 317
41, 53542912, 24533072, 53362876, 28829804, 22801568, 80386555, 317
42, 53542912, 26253996, 55083800, 28829804, 22801568, 89205305, 317
43, 53542912, 27974984, 56804788, 28829804, 22801568, 92293749, 317
44, 53542912, 29696052, 58525856, 28829804, 22801568, 94881841, 317
45, 53542912, 31417072, 60246876, 28829804, 22801568, 95672390, 317
46, 53542912, 33138172, 61967976, 28829804, 22801568, 97678668, 317
47, 53542912, 34859208, 63689012, 28829804, 22801568, 98654982, 317
48, 53542912, 6081784, 65410176, 59328392, 22801568, 99870415, 149382311
49, 53542912, 7802772, 67131164, 59328392, 22801568, 99865744, 317
50, 53542912, 9523936, 68852328, 59328392, 22801568, 100241988, 317
51, 53542912, 8361784, 70573364, 62211580, 22801568, 102056803, 205392311
52, 53542912, 10082980, 72294560, 62211580, 22801568, 102061554, 317
53, 53542912, 11803984, 74015564, 62211580, 22801568, 102056254, 317
54, 53542912, 13525148, 75736728, 62211580, 22801568, 104015974, 317
55, 53542912, 11401784, 77457796, 66056012, 22801568, 104247706, 280072311
56, 53542912, 13123012, 79179024, 66056012, 22801568, 104252221, 317
57, 53542912, 14844128, 80900140, 66056012, 22801568, 104249356, 317
58, 53542912, 16565132, 82621144, 66056012, 22801568, 104246077, 317
59, 53542912, 14441784, 84342308, 69900524, 22801568, 104250356, 354752311
60, 53542912, 16162916, 86063440, 69900524, 22801568, 104992627, 317
61, 53542912, 17884016, 87784540, 69900524, 22801568, 106438845, 317
62, 53542912, 19605084, 89505608, 69900524, 22801568, 106437883, 317
63, 53542912, 21326280, 91226804, 69900524, 22801568, 106441200, 317
64, 53542912, 18241784, 92947936, 74706152, 22801568, 106439630, 448102311
65, 53542912, 19962916, 94669068, 74706152, 22801568, 106439748, 317
66, 53542912, 21683920, 96390072, 74706152, 22801568, 106435900, 317
67, 53542912, 23405020, 98111172, 74706152, 22801568, 108159577, 317
68, 53542912, 25126216, 99832368, 74706152, 22801568, 108631377, 317
69, 53542912, 26847284, 101553436, 74706152, 22801568, 108627765, 317
70, 53542912, 22801784, 103274568, 80472784, 22801568, 108629630, 560122311
71, 53542912, 24522852, 104995636, 80472784, 22801568, 108627942, 317
72, 53542912, 26244144, 106716928, 80472784, 22801568, 108634145, 317
73, 53542912, 27965260, 108438044, 80472784, 22801568, 108629415, 317
74, 53542912, 29686392, 110159176, 80472784, 22801568, 108629453, 317
75, 53542912, 31407396, 111880180, 80472784, 22801568, 108626195, 317
76, 53542912, 33128528, 113601312, 80472784, 22801568, 108629689, 317
77, 53542912, 34849692, 115322476, 80472784, 22801568, 108630474, 317
78, 67633152, 28881784, 117043608, 88161824, 28881568, 108629630, 709561001
79, 67633152, 30602820, 118764644, 88161824, 28881568, 108626921, 317
80, 67633152, 32324048, 120485872, 88161824, 28881568, 110118243, 317
81, 67633152, 32325300, 120487124, 88161824, 28881568, 1345899853, 317
82, 67633152, 32326528, 120488352, 88161824, 28881568, 1345899314, 317
83, 67633152, 32327756, 120489580, 88161824, 28881568, 1345899314, 317
84, 67633152, 32328984, 120490808, 88161824, 28881568, 1345899314, 317
85, 67633152, 32330212, 120492036, 88161824, 28881568, 1345899314, 317
86, 67633152, 32331440, 120493264, 88161824, 28881568, 1345899314, 317
87, 67633152, 32332668, 120494492, 88161824, 28881568, 1345899314, 317
88, 67633152, 32333896, 120495720, 88161824, 28881568, 1345899314, 317
89, 67633152, 32335124, 120496948, 88161824, 28881568, 1345899314, 317
90, 67633152, 32336352, 120498176, 88161824, 28881568, 1345899314, 317

