Step, Memory, Heap, Allocated, Reclaimed, Live, Mutator, Collector
0, 4653056, 761784, 1719908, 958124, 761568, 104013452, 21147741
1, 6160384, 1521784, 3440828, 1919044, 1521568, 115001912, 42272001
2, 6160384, 3242768, 5161812, 1919044, 1521568, 118852116, 322
3, 10158080, 3041784, 6882876, 3841092, 3041568, 122084290, 84520166
4, 10158080, 4762804, 8603896, 3841092, 3041568, 123064313, 322
5, 13238272, 4561784, 10324996, 5763212, 4561568, 125565106, 126760521
6, 13238272, 6282820, 12046032, 5763212, 4561568, 126782004, 322
7, 16252928, 6081784, 13767196, 7685412, 6081568, 128297700, 169000166
8, 16252928, 7802772, 15488184, 7685412, 6081568, 128291219, 322
9, 16252928, 9523936, 17209348, 7685412, 6081568, 128760927, 322
10, 21757952, 8361784, 18930384, 10568600, 8361568, 131023030, 232373656
11, 21757952, 10082980, 20651580, 10568600, 8361568, 131029293, 322
12, 21757952, 11803984, 22372584, 10568600, 8361568, 131021659, 322
13, 21757952, 13525148, 24093748, 10568600, 8361568, 133465568, 322
14, 28835840, 11401784, 25814816, 14413032, 11401568, 133754031, 316862176
15, 28835840, 13123012, 27536044, 14413032, 11401568, 133760220, 322
16, 28835840, 14844128, 29257160, 14413032, 11401568, 133756037, 322
17, 28835840, 16565132, 30978164, 14413032, 11401568, 133751807, 322
18, 34930688, 14441784, 32699328, 18257544, 14441568, 133757700, 401336851
19, 34930688, 16162916, 34420460, 18257544, 14441568, 134682638, 322
20, 34930688, 17884016, 36141560, 18257544, 14441568, 136485254, 322
21, 34930688, 19605084, 37862628, 18257544, 14441568, 136483957, 322
22, 34930688, 21326280, 39583824, 18257544, 14441568, 136489145, 322
23, 43450368, 18241784, 41304956, 23063172, 18241568, 136486551, 506949986
24, 43450368, 19962916, 43026088, 23063172, 18241568, 136486551, 322
25, 43450368, 21683920, 44747092, 23063172, 18241568, 136481585, 322
26, 43450368, 23405020, 46468192, 23063172, 18241568, 138630318, 322
27, 43450368, 25126216, 48189388, 23063172, 18241568, 139219219, 322
28, 43450368, 26847284, 49910456, 23063172, 18241568, 139213957, 322
29, 53542912, 22801784, 51631588, 28829804, 22801568, 139216329, 633678506
30, 53542912, 22803036, 51632840, 28829804, 22801568, 1256990128, 322
31, 53542912, 22804264, 51634068, 28829804, 22801568, 1256989442, 322
32, 53542912, 22805492, 51635296, 28829804, 22801568, 1256989442, 322
33, 53542912, 22806720, 51636524, 28829804, 22801568, 1256989442, 322
34, 53542912, 22807948, 51637752, 28829804, 22801568, 1256989442, 322
35, 53542912, 22809176, 51638980, 28829804, 22801568, 1256989442, 322
36, 53542912, 22810404, 51640208, 28829804, 22801568, 1256989442, 322
37, 53542912, 22811632, 51641436, 28829804, 22801568, 1256989442, 322
38, 53542912, 22812860, 51642664, 28829804, 22801568, 1256989442, 322
39, 53542912, 22814088, 51643892, 28829804, 22801568, 1256989442, 322
40, 53542912, 22815172, 51644976, 28829804, 22801568, 14978, 322
41, 53542912, 24533752, 53363556, 28829804, 22801568, 104000921, 322
42, 53542912, 26254676, 55084480, 28829804, 22801568, 115001838, 322
43, 53542912, 27975664, 56805468, 28829804, 22801568, 118852338, 322
44, 53542912, 29696732, 58526536, 28829804, 22801568, 122078743, 322
45, 53542912, 31417752, 60247556, 28829804, 22801568, 123064535, 322
46, 53542912, 33138852, 61968656, 28829804, 22801568, 125565476, 322
47, 53542912, 34859888, 63689692, 28829804, 22801568, 126782152, 322
48, 53542912, 6081784, 65410856, 59329072, 22801568, 128297552, 168983836
49, 53542912, 7802772, 67131844, 59329072, 22801568, 128291219, 322
50, 53542912, 9523936, 68853008, 59329072, 22801568, 128760927, 322
51, 53542912, 8361784, 70574044, 62212260, 22801568, 131023030, 232343836
52, 53542912, 10082980, 72295240, 62212260, 22801568, 131029293, 322
53, 53542912, 11803984, 74016244, 62212260, 22801568, 131021659, 322
54, 53542912, 13525148, 75737408, 62212260, 22801568, 133465568, 322
55, 53542912, 11401784, 77458476, 66056692, 22801568, 133754031, 316823836
56, 53542912, 13123012, 79179704, 66056692, 22801568, 133760220, 322
57, 53542912, 14844128, 80900820, 66056692, 22801568, 133756037, 322
58, 53542912, 16565132, 82621824, 66056692, 22801568, 133751807, 322
59, 53542912, 14441784, 84342988, 69901204, 22801568, 133757700, 401303836
60, 53542912, 16162916, 86064120, 69901204, 22801568, 134682638, 322
61, 53542912, 17884016, 87785220, 69901204, 22801568, 136485254, 322
62, 53542912, 19605084, 89506288, 69901204, 22801568, 136483957, 322
63, 53542912, 21326280, 91227484, 69901204, 22801568, 136489145, 322
64, 53542912, 18241784, 92948616, 74706832, 22801568, 136486551, 506903836
65, 53542912, 19962916, 94669748, 74706832, 22801568, 136486551, 322
66, 53542912, 21683920, 96390752, 74706832, 22801568, 136481585, 322
67, 53542912, 23405020, 98111852, 74706832, 22801568, 138630318, 322
68, 53542912, 25126216, 99833048, 74706832, 22801568, 139219219, 322
69, 53542912, 26847284, 101554116, 74706832, 22801568, 139213957, 322
70, 53542912, 22801784, 103275248, 80473464, 22801568, 139216329, 633623836
71, 53542912, 24522852, 104996316, 80473464, 22801568, 139214031, 322
72, 53542912, 26244144, 106717608, 80473464, 22801568, 139222962, 322
73, 53542912, 27965260, 108438724, 80473464, 22801568, 139216111, 322
74, 53542912, 29686392, 110159856, 80473464, 22801568, 139216699, 322
75, 53542912, 31407396, 111880860, 80473464, 22801568, 139211659, 322
76, 53542912, 33128528, 113601992, 80473464, 22801568, 139216773, 322
77, 53542912, 34849692, 115323156, 80473464, 22801568, 139217848, 322
78, 67633152, 28881784, 117044288, 88162504, 28881568, 139216699, 802660161
79, 67633152, 30602820, 118765324, 88162504, 28881568, 139212734, 322
80, 67633152, 32324048, 120486552, 88162504, 28881568, 141072619, 322
81, 67633152, 32325300, 120487804, 88162504, 28881568, 1705981419, 322
82, 67633152, 32326528, 120489032, 88162504, 28881568, 1705980733, 322
83, 67633152, 32327756, 120490260, 88162504, 28881568, 1705980733, 322
84, 67633152, 32328984, 120491488, 88162504, 28881568, 1705980733, 322
85, 67633152, 32330212, 120492716, 88162504, 28881568, 1705980733, 322
86, 67633152, 32331440, 120493944, 88162504, 28881568, 1705980733, 322
87, 67633152, 32332668, 120495172, 88162504, 28881568, 1705980733, 322
88, 67633152, 32333896, 120496400, 88162504, 28881568, 1705980733, 322
89, 67633152, 32335124, 120497628, 88162504, 28881568, 1705980733, 322
90, 67633152, 32336352, 120498856, 88162504, 28881568, 1705980733, 322

