Step, Memory, Heap, Allocated, Reclaimed, Live, Mutator, Collector
0, 4718592, 761756, 1720176, 958420, 761560, 68082376, 25299425
1, 6225920, 1521756, 3442568, 1920812, 1521560, 75215887, 50572250
2, 6225920, 3244212, 5165024, 1920812, 1521560, 77712191, 252
3, 10223616, 3041756, 6887560, 3845804, 3041560, 79804560, 101117965
4, 10223616, 4764248, 8610052, 3845804, 3041560, 80443042, 252
5, 13238272, 4561756, 10332624, 5770868, 4561560, 82064585, 151662930
6, 13238272, 6284264, 12055132, 5770868, 4561560, 82853401, 252
7, 16318464, 6081756, 13777768, 7696012, 6081560, 83836191, 202207960
8, 16318464, 7804216, 15500228, 7696012, 6081560, 83831934, 252
9, 16318464, 9526852, 17222864, 7696012, 6081560, 84136592, 252
10, 21823488, 8361756, 18945372, 10583616, 8361560, 85602979, 278026555
11, 21823488, 10084424, 20668040, 10583616, 8361560, 85606994, 252
12, 21823488, 11806900, 22390516, 10583616, 8361560, 85602176, 252
13, 21823488, 13529536, 24113152, 10583616, 8361560, 87186741, 252
14, 28835840, 11401756, 25835692, 14433936, 11401560, 87373782, 379117240
15, 28835840, 13124456, 27558392, 14433936, 11401560, 87377797, 252
16, 28835840, 14847044, 29280980, 14433936, 11401560, 87375146, 252
17, 28835840, 16569520, 31003456, 14433936, 11401560, 87372176, 252
18, 34930688, 14441756, 32726092, 18284336, 14441560, 87376191, 480206820
19, 34930688, 16164360, 34448696, 18284336, 14441560, 87975981, 252
20, 34930688, 17886932, 36171268, 18284336, 14441560, 89144585, 252
21, 34930688, 19609472, 37893808, 18284336, 14441560, 89143782, 252
22, 34930688, 21332140, 39616476, 18284336, 14441560, 89146994, 252
23, 43515904, 18241756, 41339080, 23097324, 18241560, 89145388, 606570470
24, 43515904, 19964360, 43061684, 23097324, 18241560, 89145388, 252
25, 43515904, 21686836, 44784160, 23097324, 18241560, 89142176, 252
26, 43515904, 23409408, 46506732, 23097324, 18241560, 90535391, 252
27, 43515904, 25132076, 48229400, 23097324, 18241560, 90916994, 252
28, 43515904, 26854616, 49951940, 23097324, 18241560, 90913782, 252
29, 53608448, 22801756, 51674544, 28872788, 22801560, 90915388, 758206145
30, 53608448, 22804480, 51677268, 28872788, 22801560, 811113350, 252
31, 53608448, 22807112, 51679900, 28872788, 22801560, 811112816, 252
32, 53608448, 22809744, 51682532, 28872788, 22801560, 811112816, 252
33, 53608448, 22812376, 51685164, 28872788, 22801560, 811112816, 252
34, 53608448, 22815008, 51687796, 28872788, 22801560, 811112816, 252
35, 53608448, 22817640, 51690428, 28872788, 22801560, 811112816, 252
36, 53608448, 22820272, 51693060, 28872788, 22801560, 811112816, 252
37, 53608448, 22822904, 51695692, 28872788, 22801560, 811112816, 252
38, 53608448, 22825536, 51698324, 28872788, 22801560, 811112816, 252
39, 53608448, 22828168, 51700956, 28872788, 22801560, 811112816, 252
40, 53608448, 22830656, 51703444, 28872788, 22801560, 7426, 252
41, 53608448, 24550708, 53423496, 28872788, 22801560, 68083953, 252
42, 53608448, 26273104, 55145892, 28872788, 22801560, 75215887, 252
43, 53608448, 27995564, 56868352, 28872788, 22801560, 77712191, 252
44, 53608448, 29718104, 58590892, 28872788, 22801560, 79804140, 252
45, 53608448, 31440596, 60313384, 28872788, 22801560, 80443042, 252
46, 53608448, 33163168, 62035956, 28872788, 22801560, 82064585, 252
47, 53608448, 34885676, 63758464, 28872788, 22801560, 82853401, 252
48, 53608448, 6081756, 65481100, 59399344, 22801560, 83836191, 202206550
49, 53608448, 7804216, 67203560, 59399344, 22801560, 83831934, 252
50, 53608448, 9526852, 68926196, 59399344, 22801560, 84136592, 252
51, 53608448, 8361756, 70648704, 62286948, 22801560, 85602979, 278024035
52, 53608448, 10084424, 72371372, 62286948, 22801560, 85606994, 252
53, 53608448, 11806900, 74093848, 62286948, 22801560, 85602176, 252
54, 53608448, 13529536, 75816484, 62286948, 22801560, 87186741, 252
55, 53608448, 11401756, 77539024, 66137268, 22801560, 87373782, 379114030
56, 53608448, 13124456, 79261724, 66137268, 22801560, 87377797, 252
57, 53608448, 14847044, 80984312, 66137268, 22801560, 87375146, 252
58, 53608448, 16569520, 82706788, 66137268, 22801560, 87372176, 252
59, 53608448, 14441756, 84429424, 69987668, 22801560, 87376191, 480204030
60, 53608448, 16164360, 86152028, 69987668, 22801560, 87975981, 252
61, 53608448, 17886932, 87874600, 69987668, 22801560, 89144585, 252
62, 53608448, 19609472, 89597140, 69987668, 22801560, 89143782, 252
63, 53608448, 21332140, 91319808, 69987668, 22801560, 89146994, 252
64, 53608448, 18241756, 93042412, 74800656, 22801560, 89145388, 606566540
65, 53608448, 19964360, 94765016, 74800656, 22801560, 89145388, 252
66, 53608448, 21686836, 96487492, 74800656, 22801560, 89142176, 252
67, 53608448, 23409408, 98210064, 74800656, 22801560, 90535391, 252
68, 53608448, 25132076, 99932732, 74800656, 22801560, 90916994, 252
69, 53608448, 26854616, 101655272, 74800656, 22801560, 90913782, 252
70, 53608448, 22801756, 103377876, 80576120, 22801560, 90915388, 758201525
71, 53608448, 24524296, 105100416, 80576120, 22801560, 90913782, 252
72, 53608448, 26247060, 106823180, 80576120, 22801560, 90919403, 252
73, 53608448, 27969648, 108545768, 80576120, 22801560, 90915146, 252
74, 53608448, 29692252, 110268372, 80576120, 22801560, 90915388, 252
75, 53608448, 31414728, 111990848, 80576120, 22801560, 90912176, 252
76, 53608448, 33137332, 113713452, 80576120, 22801560, 90915388, 252
77, 53608448, 34859968, 115436088, 80576120, 22801560, 90916191, 252
78, 67698688, 28881756, 117158692, 88276936, 28881560, 90915388, 960387975
79, 67698688, 30604264, 118881200, 88276936, 28881560, 90912979, 252
80, 67698688, 32326964, 120603900, 88276936, 28881560, 92118774, 252
81, 67698688, 32329688, 120606624, 88276936, 28881560, 1101070677, 252
82, 67698688, 32332500, 120609436, 88276936, 28881560, 1101070143, 252
83, 67698688, 32335312, 120612248, 88276936, 28881560, 1101070143, 252
84, 67698688, 32338124, 120615060, 88276936, 28881560, 1101070143, 252
85, 67698688, 32340936, 120617872, 88276936, 28881560, 1101070143, 252
86, 67698688, 32343748, 120620684, 88276936, 28881560, 1101070143, 252
87, 67698688, 32346560, 120623496, 88276936, 28881560, 1101070143, 252
88, 67698688, 32349372, 120626308, 88276936, 28881560, 1101070143, 252
89, 67698688, 32352184, 120629120, 88276936, 28881560, 1101070143, 252
90, 67698688, 32354996, 120631932, 88276936, 28881560, 1101070143, 252

